NO ./textures/north.xpm
SO ./textures/south.xpm
WE ./textures/west.xpm
EA ./textures/east.xpm

F 205,192,203
C 99,0,128



      1111111111
   111001111100011111
   100000000000000001
   100001111100000001
   11100000000000001
      11111111111111   