NO ./textures/north.xpm
SO ./textures/south.xpm
WE ./textures/west.xpm
EA ./textures/east.xpm

F 205, 192, 203
C 99, 0, 128

  
  
  
  111111111
  1000000001
   1000000N1
    111111111 