NO ./textures/north.xpm
SO ./textures/south.xpm
WE ./textures/west.xpm
EA ./textures/east.xpm

F 205,192,203
C 99,0,128



111111
100001
101001
1100S1
111111