111111
100001
101001
1100W1
111111