NO ./textures/north.xpm
SO ./textures/south.xpm
WE ./textures/west.xpm
EA ./textures/east.xpm

F 205, 192, 203
C 99, 0, 128


11111111111111111111111111111111111111111111111111111111111111111111111111111111111111
                                                                1000000000001100000001
                                                                1000000000000000000001
                                                                1000000000000000000001
                                                                 111111111110000111111
                                                                          100001
                                                                          100001
                                                    1111111111111111111111100001
                                                    1000000000000000000000000001
                                                    1000000000000000000000000001
                                                    1000000001111111111111111111
                                                    1000000001
                                                    1000000001
              111111111111111111111111111111111111111000110001
              100000000000000000000000000000000000000000000001
111111111111111000000000000000000000000000000000000000000000011111
1000000000000000000000000000000000000000000000000000000000000000011
100000000000000000000000000000000000000000000000000000000000000000011111111
100000000000000000000000000000011111110011111110000000000000000000000100001
10000001111111000000000000000010000000000000001000000000000000000000010001
10000001     1000000000000000010000000000000001000000000000000000000010001
10000001     1000000000000000000000000E000000011111000000000000000000000001
10000001     10000000000000000100000000000000011111100000000000000000000001
10000001     10000000000000000100000000000000110000000000000000000000000001
10000001     1000000000000000011111111111111111000000000000000000001111111
10000001     1000000000000000000000000000000000000000000000001111111
1000001      1000000000000000000000000000000000000000000000001     1
1000001      1111111111111111111100000111111111111111111111111111111
1000001                          10001
10000001                         10001
10000001111111111111111111111111110001
10000000000000000000000000000000000001
10000000000000000000000000000000000001
10000000000010000000000000000000000001
11111111111111111111111111111111111111