      1111111111
   111001111100011111
   100000000000000001
   100001111100000001
   111000000N00000001
      11111111111111   