NO         ./textures/north.xpm
SO ./textures/south.xpm
WE ./textures/west.xpm
EA ./textures/east.xpm

F    119,110,101
C 255,0,125

          1111111111111111111
          10000000001
11111111110000000001
1000000000000000001
100000000N000000001
1000000000000000001
1000000000000000001
1000000000000000001
1111111111111111111