NO ./textures/north.xpm
SO ./textures/south.xpm
WE ./textures/west.xpm
EA ./textures/east.xpm

C 99, 0, 128
F 205, 192, 203

1
     11111111111111111111
1111110000000000000000001
1000000000000000000000001
1000000001000000000000001
1000000000000000000000001
1000000000000000000000001
1000000001000000000000001
10000000N0100000000000001
1000001100000110000000001
1000000001000000000000001
1111111111111111111111111