NO ./resourses/bricks.xpm
SO ./resourses/hello_world.xpm
WE ./resourses/blocks.xpm
EA          ./resourses/pixil.xpm

C      99, 0, 128
F 205, 192, 203

1111111111111111111111111
1000000000000000000000001
1000000000000000000000001
1000000001000000000000001
1000000000000000000000001
1000000000000000000000001
1000000001000000000000001
10000000N0100000000000001
1000001100000110000000001
1000000001000000000000001
1111111111111111111111111